{
  "name": "Level 2",
  "index": 2,
  "layout": [
    "- -- -- -- -- -- -- -- -- -- -- -- -- -- -",
    " x  x  x  x  x  x  x  x  x  x  x  x  x  x ",
    "- -- -- -- -- -- -- -- -- -- -- -- -- -- -",
    "- -- -- -- -- -- -- -- -- -- -- -- -- -- -",
    " x                                      x ",
    "- -- -- -- -- -- -- -- -- -- -- -- -- -- -",
    "- -- -- -- -- -- -- -- -- -- -- -- -- -- -",
    " x                                      x ",
    "- -- -- -- -- -- -- -- -- -- -- -- -- -- -",
    "- -- -- -- -- -- -- -- -- -- -- -- -- -- -",
    " x                                      x ",
    "- -- -- -- -- -- -- -- -- -- -- -- -- -- -",
    "- -- -- -- -- -- -- -- -- -- -- -- -- -- -",
    " x                 g           g        x ",
    "- -- -- -- -- -- -- -- -- -- -- -- -- -- -",
    "- -- -- -- -- -- -- -- -- -- -- -- -- -- -",
    " x           r     r           r        x ",
    "- -- -- -- -- -- -- -- -- -- -- -- -- -- -",
    "- -- -- -- -- -- -- -- -- -- -- -- -- -- -",
    " x  x  x  x  x     x     x     x  x  x  x ",
    "- -- -- -- -- -- -- -- -- -- -- -- -- -- -",
    "- -- -- -- -- -- -- -- -- -- -- -- -- -- -",
    " x  x  x  x  x  x  x  x  x  x  x  x  x  x ",
    "- -- -- -- -- -- -- -- -- -- -- -- -- -- -",
    "- -- -- -- -- -- -- -- -- -- -- -- -- -- -",
    " x  x  x  x  x  x  x  x  x  x  x  x  x  x ",
    "- -- -- -- -- -- -- -- -- -- -- -- -- -- -",
    "- -- -- -- -- -- -- -- -- -- -- -- -- -- -",
    " x  x  x  x  x  x  x  x  x  x  x  x  x  x ",
    "- -- -- -- -- -- -- -- -- -- -- -- -- -- -"
  ],
  "solution": [
    {
      "x": 6,
      "y": 4,
      "left": true
    },
    {
      "x": 4,
      "y": 5,
      "left": false
    },
    {
      "x": 5,
      "y": 5,
      "left": false
    },
    {
      "x": 6,
      "y": 5,
      "left": false
    },
    {
      "x": 7,
      "y": 5,
      "left": false
    },
    {
      "x": 10,
      "y": 4,
      "left": true
    },
    {
      "x": 9,
      "y": 4,
      "left": true
    },
    {
      "x": 10,
      "y": 5,
      "left": true
    },
    {
      "x": 9,
      "y": 5,
      "left": true
    },
    {
      "x": 8,
      "y": 4,
      "left": true
    },
    {
      "x": 7,
      "y": 4,
      "left": true
    },
    {
      "x": 6,
      "y": 4,
      "left": true
    }
  ]
}