{
  "name": "Level 30",
  "index": 30,
  "layout": [
    "- -- -- -- -- -- -- -- -- -- -- -- -- -- -",
    " x  x  x  x  x  x  x  x  x  x  x  x  x  x ",
    "- -- -- -- -- -- -- -- -- -- -- -- -- -- -",
    "- --a-- -- -- -- -- -- -- -- -- -- -- -- -",
    " x  r              x  x  x  x  x  x  x  x ",
    "- -- -- -- -- -- -- -- -- -- -- -- -- -- -",
    "- -- -- -- -- -- -- -- -- -- -- -- -- -- -",
    " x  x  x                         bx  x  x ",
    "- -- -- -- -- -- -- -- -- -- -- -- -- -- -",
    "- -- -- -- -- -- -- -- -- -- -- -- -- -- -",
    " x  x  x  x                      bx  x  x ",
    "- -- -- -- -- -- -- -- -- -- -- -- -- -- -",
    "- -- -- -- -- -- -- -- -- -- -- -- -- -- -",
    " x  x  x  x                      bx  x  x ",
    "- -- -- -- -- -- -- -- -- -- -- -- -- -- -",
    "- -- -- -- -- -- -- -- -- -- -- -- -- -- -",
    " x  x  x  x                      bx  x  x ",
    "- -- -- -- -- -- -- -- -- -- -- -- -- -- -",
    "- -- -- -- -- -- -- -- -- -- -- -- -- -- -",
    " x  x  x  x                      bx  x  x ",
    "- -- -- -- -- -- -- -- -- -- -- -- -- -- -",
    "- -- -- -- -- -- -- -- -- -- -- -- -- -- -",
    " x  r  r  r                      bx  x  x ",
    "- -- -- -- -- -- -- -- -- -- -- -- -- -- -",
    "- -- -- -- -- -- -- -- -- -- -- -- -- -- -",
    " x  x  r                          b  x  x ",
    "- -- -- -- -- -- -- -- -- -- -- -- -- -- -",
    "- -- -- -- -- --b--b--b--b--b--b-- -- -- -",
    " x  x  x  x  x  x  x  x  x  x  x  x  x  x ",
    "- -- -- -- -- -- -- -- -- -- -- -- -- -- -"
  ],
  "solution": [
    {
      "x": 3,
      "y": 7,
      "left": false
    },
    {
      "x": 3,
      "y": 7,
      "left": false
    },
    {
      "x": 4,
      "y": 7,
      "left": false
    },
    {
      "x": 5,
      "y": 7,
      "left": false
    },
    {
      "x": 6,
      "y": 7,
      "left": false
    },
    {
      "x": 7,
      "y": 7,
      "left": false
    },
    {
      "x": 7,
      "y": 7,
      "left": false
    },
    {
      "x": 11,
      "y": 8,
      "left": true
    }
  ]
}