{
  "name": "Level 30",
  "index": 30,
  "layout": [
    "- -- -- -- -- -- -- -- -- -- -- -- -- -- -",
    " x  x  x  x  x  x  x  x  x  x  x  x  x  x ",
    "- -- -- -- -- -- -- -- -- -- -- -- -- -- -",
    "- --a-- -- -- -- -- -- -- -- -- -- -- -- -",
    " x  r              x  x  x  x  x  x  x  x ",
    "- -- -- -- -- -- -- -- -- -- -- -- -- -- -",
    "- -- -- -- -- -- -- -- -- -- -- -- -- -- -",
    " x  x  x                         bx  x  x ",
    "- -- -- -- -- -- -- -- -- -- -- -- -- -- -",
    "- -- -- -- -- -- -- -- -- -- -- -- -- -- -",
    " x  x  x  x                      bx  x  x ",
    "- -- -- -- -- -- -- -- -- -- -- -- -- -- -",
    "- -- -- -- -- -- -- -- -- -- -- -- -- -- -",
    " x  x  x  x                      bx  x  x ",
    "- -- -- -- -- -- -- -- -- -- -- -- -- -- -",
    "- -- -- -- -- -- -- -- -- -- -- -- -- -- -",
    " x  x  x  x                      bx  x  x ",
    "- -- -- -- -- -- -- -- -- -- -- -- -- -- -",
    "- -- -- -- -- -- -- -- -- -- -- -- -- -- -",
    " x  x  x  x                      bx  x  x ",
    "- -- -- -- -- -- -- -- -- -- -- -- -- -- -",
    "- -- -- -- -- -- -- -- -- -- -- -- -- -- -",
    " x  r  r  r                      bx  x  x ",
    "- -- -- -- -- -- -- -- -- -- -- -- -- -- -",
    "- -- -- -- -- -- -- -- -- -- -- -- -- -- -",
    " x  x  r                          b  x  x ",
    "- -- -- -- -- -- -- -- -- -- -- -- -- -- -",
    "- -- -- -- -- --b--b--b--b--b--b-- -- -- -",
    " x  x  x  x  x  x  x  x  x  x  x  x  x  x ",
    "- -- -- -- -- -- -- -- -- -- -- -- -- -- -"
  ],
  "solution": [
  ]
}