{
  "name": "Level 32",
  "index": 32,
  "layout": [
    "- -- -- -- -- -- -- -- -- -- -- -- -- -- -",
    " x  x  x  x  x  x  x  x  x  x  x  x  x  x ",
    "- -- -- -- -- -- -- -- -- -- -- -- -- -- -",
    "- -- -- -- -- -- -- -- -- -- -- -- -- -- -",
    " x  g           y           x  ra 3 ab  x ",
    "- --a-- -- -- --a-- -- -- -- -- -- -- -- -",
    "- -- -- -- -- -- -- -- -- -- -- -- -- -- -",
    " x  0           1              ya 4 ag  x ",
    "- -- -- -- -- -- -- -- -- -- -- -- -- -- -",
    "- --a-- -- -- --a-- -- -- -- -- -- -- -- -",
    " x  b           r  2  2              x  x ",
    "- -- -- -- -- -- -- -- -- -- -- -- -- -- -",
    "- -- -- -- -- -- -- -- -- -- -- -- -- -- -",
    " x  x           x  x  x           x  x  x ",
    "- -- -- -- -- -- -- -- -- -- -- -- -- -- -",
    "- -- -- -- -- -- -- -- -- -- -- -- -- -- -",
    " x                                   x  x ",
    "- -- -- -- -- -- -- -- -- -- -- -- -- -- -",
    "- -- -- -- -- -- -- -- -- -- -- -- -- -- -",
    " x                       x  x        x  x ",
    "- -- -- -- -- -- -- -- -- -- -- -- -- -- -",
    "- -- -- -- -- -- -- -- -- -- -- -- -- -- -",
    " x  x                                x  x ",
    "- -- -- -- -- -- -- -- -- -- -- -- -- -- -",
    "- -- -- -- -- -- -- -- -- -- -- -- -- -- -",
    " x  x  x                          x  x  x ",
    "- -- -- -- -- -- -- -- -- -- -- -- -- -- -",
    "- -- -- -- -- -- -- -- -- -- -- -- -- -- -",
    " x  x  x  x  x  x  x  x  x  x  x  x  x  x ",
    "- -- -- -- -- -- -- -- -- -- -- -- -- -- -"
  ],
  "solution": [
  ]
}