{
  "name": "Level 33",
  "index": 33,
  "layout": [
    "- -- -- -- -- -- -- -- -- -- -- -- -- -- -",
    " x  x  x  x  x  x  x  x  x  x  x  x  x  x ",
    "- -- -- -- -- -- -- -- -- -- -- -- -- -- -",
    "- -- -- -- -- -- -- -- -- -- -- -- -- -- -",
    " x  x  0  0  1  1              x  x  x  x ",
    "- -- -- -- -- -- -- -- -- -- -- -- -- -- -",
    "- -- -- -- -- -- -- -- -- -- -- -- -- -- -",
    " x  r  0  2  2  1              x  x  x  x ",
    "- -- -- -- -- -- -- -- -- -- -- -- -- -- -",
    "- -- -- -- -- -- -- -- -- -- -- -- -- -- -",
    " x  x  3  2  2  4              x  x  x  x ",
    "- -- -- -- -- -- -- -- -- -- -- -- -- -- -",
    "- -- -- -- -- -- -- -- -- -- -- -- -- -- -",
    " x  x  3  3  4  4              x  x  x  x ",
    "- -- -- -- -- -- -- -- -- -- -- -- -- -- -",
    "- -- -- -- -- -- -- -- -- -- -- -- --a-- -",
    " x  x  x  x  x  x              x  x  r  x ",
    "- -- -- -- -- -- -- -- -- -- -- -- -- -- -",
    "- -- -- -- -- -- -- -- -- -- -- -- -- -- -",
    " x  xr                                  x ",
    "- -- -- -- -- -- -- -- -- -- -- -- -- -- -",
    "- -- -- -- -- -- -- -- -- -- -- -- -- -- -",
    " x  x  x                                x ",
    "- -- -- -- -- -- -- -- -- -- -- -- -- -- -",
    "- -- -- -- -- -- -- -- -- -- -- -- -- -- -",
    " x  x                 x  x        x     x ",
    "- -- -- -- -- -- -- -- -- -- -- -- -- -- -",
    "- -- -- -- -- -- -- -- -- -- -- -- -- -- -",
    " x  x  x  x  x  x  x  x  x  x  x  x  x  x ",
    "- -- -- -- -- -- -- -- -- -- -- -- -- -- -"
  ],
  "solution": [
  ]
}